English	Prime	Dutch	MovieFile			
ACCORDION	accordeon	ACCORDEON	ACCORDION.mpeg			
AMBULANCE	amublance	AMBULANCE	AMBULANCE.mpeg			
APPEL	appel	APPEL	APPLE.mpeg			
AVOCADO	avocado	AVOCADO	AVOCADO.mpeg			
BABY	baby	BABY	BABY.mpeg			
BAL	bal	BAL	BALL.mpeg			
BANANA	banaan	BANAAN	BANANA.mpeg			
BATH	bad	BAD	BATH.mpeg			
BEAR	beer	BEER	BEAR.mpeg			
BED	bed	BED	BED.mpeg			
BEER	bier	BIER	BEER.mpeg			
BELT	riem	RIEM	BELT.mpeg			
BICYCLE	fiets	FIETS	BICYCLE.mpeg			
BINOCULARS	verrekijker	VERREKIJKER	BINOCULARS.mpeg			
BIRD	vogel	VOGEL	BIRD.mpeg			
BITE	hapje	HAPJE	BITE.mpeg			
BLANKET	deken	DEKEN	BLANKET.mpeg			
BLENDER	blender	BLENDER	BLENDER.mpeg			
BOAT	boot	BOOT	BOAT.mpeg			
BOOK	boek	BOEK	BOOK.mpeg			
BOOKSHELF	boekenplank	BOEKENPLANK	BOOKSHELF.mpeg			
BOTERHAM	boterham	BOTERHAM	BOTERHAM.mpeg			
BOTTLE	fles	FLES	BOTTLE.mpeg			
BOX	doos	DOOS	BOX.mpeg			
BREAD	brood	BROOD	BREAD.mpeg			
BRIDGE	brug	BRUG	BRIDGE.mpeg			
BUILDING	gebouw	GEBOUW	BUILDING.mpeg			
BUS	bus	BUS	BUS.mpeg			
BUTTERFLY	vlinder	VLINDER	BUTTERFLY.mpeg			
CALCULATOR	rekenmachine	REKENMACHINE	CALCULATOR.mpeg			
CAMEL	kameel	KAMEEL	CAMEL.mpeg			
CAR	auto	AUTO	CAR.mpeg			
CAT	kat	KAT	CAT.mpeg			
CELL (prison)	gevangenis	GEVANGENIS	CELL.mpeg			
CHICKEN	kip	KIP	CHICKEN.mpeg			
CHILD	kind	KIND	CHILD.mpeg			
CLOCK	klok	KLOK	CLOCK.mpeg			
COCONUT(NUT)	kokosnoot	KOKOSNOOT	COCONUT.mpeg			
COFFEE	koffie	KOFFIE	COFFEE.mpeg			
COW	koe	KOE	COW.mpeg			
COWBOY	cowboy	COWBOY	COWBOY.mpeg			
CURTAINS	gordijnen	GORDIJNEN	CURTAINS.mpeg			
DEER	hert	HERT	DEER.mpeg			
DOCTOR	dokter	DOKTER	DOCTOR.mpeg			
DOG	hond	HOND	DOG.mpeg			
DOOR	deur	DEUR	DOOR.mpeg			
DRILL	boor	BOOR	DRILL.mpeg			
DROPS	druppels	DRUPPELS	DROPS.mpeg			
DUCK	eend	EEND	DUCK.mpeg			
EAGLE	adelaar	ADELAAR	EAGLE.mpeg			
ELECTRICITY	elektriciteit	ELEKTRICITEIT	ELECTRICITY.mpeg			
ELEPHANT	olifant	OLIFANT	ELEPHANT.mpeg			
FIRE	vuur	VUUR	FIRE.mpeg			
FLOOR	verdieping	VERDIEPING	FLOOR.mpeg			
FLOWER	bloem	BLOEM	FLOWER.mpeg			
FOX	vos	VOS	FOX.mpeg			
FROG	kikker	KIKKER	FROG.mpeg			
FRUIT	fruit	FRUIT	FRUIT.mpeg			
GIRAFFE	giraf	GIRAF	GIRAFFE.mpeg			
GOAT	geit	GEIT	GOAT.mpeg			
GUITAR	gitaar	GITAAR	GUITAR.mpeg			
HAIR	haar	HAAR	HAIR.mpeg			
HAT	hoed	HOED	HAT.mpeg			
HELICOPTER	helikopter	HELIKOPTER	HELICOPTER.mpeg			
HIPPO	nijlpaard	NIJLPAARD	HIPPO.mpeg			
HORSE	paard	PAARD	HORSE.mpeg			
HOUSE	huis	HUIS	HOUSE.mpeg			
ICE-CREAM	ijsje	IJSJE	ICE-CREAM.mpeg			
INTERPRETER	tolk	TOLK	INTERPRETER.mpeg			
IPAD	iPad	IPAD	IPAD.mpeg			
IPHONE	iPhone	IPHONE	IPHONE.mpeg			
JACKET	jas	JAS	JACKET.mpeg			
KEY	sleutel	SLEUTEL	KEY.mpeg			
KIWI	kiwi	KIWI	KIWI.mpeg			
LAPTOP	laptop	LAPTOP	LAPTOP.mpeg			
LIGHTBULB	gloeilamp	GLOEILAMP	LIGHTBULB.mpeg			
LIGHTER	aansteker	AANSTEKER	LIGHTER.mpeg			
LION	leeuw	LEEUW	LION.mpeg			
LOBSTER	kreeft	KREEFT	LOBSTER.mpeg			
MILK	melk	MELK	MILK.mpeg			
MONKEY	aap	AAP	MONKEY.mpeg			
MOSQUITO	mug	MUG	MOSQUITO.mpeg			
MOTORBIKE	brommer	BROMMER	MOTORBIKE.mpeg			
MUG	mok	MOK	MUG.mpeg			
MUMMY	mama	MAMA	MUMMY.mpeg			
MUSHROOM	champignon	CHAMPIGNON	MUSHROOM.mpeg			
MUSIC	muziek	MUZIEK	MUSIC.mpeg			
ORANGE (fruit)	sinaasappel	SINAASAPPEL	ORANGE.mpeg			
OWL	uil	UIL	OWL.mpeg			
PENGUIN	pinguin	PINGUIN	PENGUIN.mpeg			
PEPPER	peper	PEPER	PEPPER.mpeg			
PERSON	persoon	PERSOON	PERSON.mpeg			
PIANO	piano	PIANO	PIANO.mpeg			
PIG	varken	VARKEN	PIG.mpeg			
PILLOW (bed)	het kussen	HET KUSSEN	PILLOW.mpeg			
PISTOL	pistool	PISTOOL	PISTOL.mpeg			
PLANE	vliegtuig	VLIEGTUIG	PLANE1.mpeg	PLANE2.mpeg		
PLASTER-CAST	gips	GIPS	PLASTER-CAST.mpeg			
POLICE OFFICER	politieagent	POLITIEAGENT	POLICE_OFFICER.mpeg			
PRAM	buggy	BUGGY	PRAM.mpeg			
PUPPET	pop	POP	PUPPET.mpeg			
PYRAMID	piramide	PIRAMIDE	PYRAMID.mpeg			
RABBIT	konijn	KONIJN	RABBIT.mpeg			
RACKET	tennis racket	TENNIS RACKET	RACKET.mpeg			
RATTLE	rammelaar	RAMMELAAR	RATTLE.mpeg			
RESTAURANT	restaurant	RESTAURANT	RESTAURANT.mpeg			
RHINO	neushoorn	NEUSHOORN	RHINO.mpeg			
ROOM	kamer	KAMER	ROOM.mpeg			
ROOSTER	haan	HAAN	ROOSTER.mpeg			
SALT	zout	ZOUT	SALT.mpeg			
SANDWICH	tosti	TOSTI	SANDWICH.mpeg			
SAXOPHONE	saxofoon	SAXOFOON	SAXOPHONE.mpeg			
SCREWDRIVER	schroevendraaier	SCHROEVENDRAAIER	SCREWDRIVER.mpeg			
SEAHORSE	zeepaard	ZEEPAARD	SEAHORSE.mpeg			
SEAL	zeehond	ZEEHOND	SEAL.mpeg			
SHEEP	schaap	SCHAAP	SHEEP.mpeg			
SKUNK	stinkdier	STINKDIER	SKUNK.mpeg			
SNAIL	slak	SLAK	SNAIL.mpeg			
SNAKE	slang	SLANG	SNAKE.mpeg			
SOAP	zeep 	ZEEP	SOAP.mpeg			
SOFA	sofa	SOFA	SOFA.mpeg			
SPIDER	spin	SPIN	SPIDER.mpeg			
SPOON	lepel	LEPEL	SPOON.mpeg			
SPREADABLE CHEESE	smeerkaas	SMEERKAAS	SPREADABLE_CHEESE.mpeg			
SQUIRREL	eekhoorn	EEKHOORN	SQUIRREL.mpeg			
STAIRS	trap	TRAP	STAIRS.mpeg			
SUBWAY	metro	METRO	SUBWAY.mpeg			
SUGAR	suiker	SUIKER	SUGAR.mpeg			
SUITCASE	koffer	KOFFER	SUITCASE.mpeg			
SUN	zon	ZON	SUN.mpeg			
TABLE	tafel	TAFEL	TABLE.mpeg			
TEA	thee	THEE	TEA.mpeg			
TELEPHONE	telefoon	TELEFOON	TELEPHONE.mpeg			
TIE	stropdas	STROPDAS	TIE.mpeg			
TO-ARGUE	ruzie maken	RUZIE MAKEN	TO-ARGUE.mpeg			
TO-BLOW	blazen	BLAZEN	TO-BLOW.mpeg	TO-BLOW2.mpeg		
TO-BREAK	breken	BREKEN	TO-BREAK.mpeg			
TO-BREATHE	ademhalen	ADEMHALEN	TO-BREATHE.mpeg			
TO-BREATHE	inademen	INADEMEN	TO-BREATHE2.mpeg			
TO-BUY	kopen	KOPEN	TO-BUY.mpeg			
TO-CARRY	dragen	DRAGEN	TO-CARRY.mpeg			
TO-CATCH	vangen	VANGEN	TO-CATCH.mpeg			
TO-CLAP	klappen	KLAPPEN	TO-CLAP.mpeg			
TO-COMB	kammen	KAMMEN	TO-COMB.mpeg			
TO-COME	komen	KOMEN	TO-COME.mpeg			
TO-COOK	koken	KOKEN	TO-COOK.mpeg			
TO-COUGH	hoesten	HOESTEN	TO-COUGH.mpeg			
TO-CRASH	botsen	BOTSEN	TO-CRASH.mpeg			
TO-CRAWL (people)	kruipen	KRUIPEN	TO-CRAWL.mpeg			
TO-CROSS-FINGERS (Dutch)	duimen	DUIMEN	TO-CROSS-FINGERS.mpeg			
TO-CRY	huilen	HUILEN	TO-CRY.mpeg			
TO-CUT (knife)	snijden	SNIJDEN	TO-CUT_knife.mpeg			
TO-CUT (scissors)	knippen	KNIPPEN	TO-CUT_scissors.mpeg			
TO-DIE	overlijden	OVERLIJDEN	TO-DIE.mpeg			
TO-DRESS/TO-WHIP	dresseren	DRESSEREN	TO-WHIP.mpeg			
TO-DRINK	drinken	DRINKEN	TO-DRINK.mpeg			
TO-DRY (someone)	afdrogen	AFDROGEN	TO-DRY.mpeg			
TO-DUST	afstoppen	AFSTOFFEN	TO-DUST.mpeg			
TO-EAT	eten	ETEN	TO-EAT.mpeg			
TO-ERASE	uitgummen	UITGUMMEN	TO-ERASE.mpeg			
TO-FAINT	flauwvallen	FLAUWVALLEN	TO-FAINT.mpeg			
TO-FISH	vissen	VISSEN	TO-FISH.mpeg			
TO-FLY (plane)	vliegen	VLIEGEN	TO-FLYplane.mpeg			
TO-FOLD	vouwen	VOUWEN	TO-FOLD.mpeg			
TO-GIVE	geven	GEVEN	TO-GIVE.mpeg			
TO-GO-DOWN	omhoog lopen	OMHOOG LOPEN	TO-GO-DOWN.mpeg			
TO-GO-OUT	uitgaan	UITGAAN	TO-GO-OUT.mpeg			
TO-GOSSIP	roddelen	RODDELEN	TO-GOSSIP.mpeg			
TO-GO-UP	omlaag lopen	OMLAAG LOPEN	TO-GO-UP.mpeg			
TO-GRAB	pakken	PAKKEN	TO-GRAB.mpeg			
TO-HAMMER	hameren	HAMEREN	TO-HAMMER.mpeg			
TO-HOOVER	stofzuigen	STOFZUIGEN	TO-HOOVER.mpeg			
TO-HUG	knuffelen	KNUFFELEN	TO-HUG.mpeg			
TOILET	toilet	TOILET	TOILET.mpeg			
TO-INJECT	injecteren	INJECTEREN	TO-INJECT.mpeg			
TO-INSERT-BEADS	rijgen	RIJGEN	TO-INSERT-BEADS.mpeg			
TO-IRON	strijken	STRIJKEN	TO-IRON.mpeg			
TO-ITCH	krabben	KRABBEN	TO-ITCH.mpeg	TO-ITCH_KRABBEN.mpeg		TO-ITCH_KRABBEN1.mpeg
TO-JOG	joggen	JOGGEN	TO-JOG.mpeg			
TO-JUGGLE	jongleren	JONGLEREN	TO-JUGGLE.mpeg			
TO-KICK	schoppen	SCHOPPEN	TO-KICK.mpeg			
TO-KISS	kussen	KUSSEN	TO-KISS.mpeg			
TO-KNEAD	kneden	KNEDEN	TO-KNEAD.mpeg			
TO-KNIT	breien	BREIEN	TO-KNIT.mpeg			
TO-KNOCK (door)	kloppen	KLOPPEN	TO-KNOCK.mpeg			
TO-KNOW	weten	WETEN	TO-KNOW.mpeg			
TO-LAUGH	lachen	LACHEN	TO-LAUGH.mpeg			
TO-LIFT	optillen	OPTILLEN	TO-LIFT.mpeg			
TO-LISTEN	luisteren	LUISTEREN	TO-LISTEN.mpeg			
TO-LOVE	houden van	HOUDEN VAN	TO-LOVE.mpeg			
TO-MASSAGE (someone)	masseren	MASSEREN	TO-MASSAGE.mpeg			
TO-MEET	ontmoeten	ONTMOETEN	TO-MEET.mpeg			
TO-OPEN	openen	OPENEN	TO-OPEN.mpeg			
TO-ORDER	bestellen	BESTELLEN	TO-ORDER.mpeg			
TOOTHBRUSH	tandenborstel	TANDENBORSTEL	TOOTHBRUSH.mpeg			
TO-PARK	parkeren	PARKEREN	TO-PARK.mpeg			
TO-PEEL (knife)	schillen	SCHILLEN	TO-PEEL.mpeg			
TO-PHONE (someone)	bellen	BELLEN	TO-PHONE.mpeg			
TO-PICK-UP	ophalen	OPHALEN	TO-PICK-UP.mpeg			
TO-PLAY-CARDS	kaarten	KAARTEN	TO-PLAY-CARDS.mpeg			
TO-PLAY-POOL	poolen	POOLEN	TO-PLAY-POOL.mpeg			
TO-POUR	gieten	GIETEN	TO-POUR.mpeg			
TO-POWDER	poederen	POEDEREN	TO-POWDER.mpeg			
TO-PRAY	bidden	BIDDEN	TO-PRAY.mpeg			
TO-PULL	trekken	TREKKEN	TO-PULL.mpeg			
TO-PUMP (tire)	oppompen	OPPOMPEN	TO-PUMP.mpeg			
TO-PUT-CLOTHES-ON	aankleden	AANKLEDEN	TO-PUT-CLOTHES-ON.mpeg			
TO-PUT-LIPSTICK-ON	lippenstiften	LIPPENSTIFTEN	TO-PUT-LIPSTICK-ON.mpeg			
TO-RAIN	regenen	REGENEN	TO-RAIN.mpeg			
TO-READ	lezen	LEZEN	TO-READ.mpeg			
TO-RELAX	ontspannen	ONTSPANNEN	TO-RELAX.mpeg			
TO-ROLL	rollen	ROLLEN	TO-ROLL.mpeg			
TO-ROW	roeien	ROEIEN	TO-ROW.mpeg			
TO-RUN	rennen	RENNEN	TO-RUN.mpeg			
TO-SAW	zagen	ZAGEN	TO-SAW.mpeg			
TO-SAY	zeggen	ZEGGEN	TO-SAY.mpeg			
TO-SEE	zien	ZIEN	TO-SEE.mpeg			
TO-SHAVE	schermen	SCHEREN	TO-SHAVE.mpeg			
TO-SHOUT	scheeuwen	SCHREEUWEN	TO-SHOUT.mpeg			
TO-SIEVE (flour)	zeven	ZEVEN	TO-SIEVE.mpeg			
TO-SIGN	gebaren	GEBAREN	TO-SIGN.mpeg			
TO-SIT	zitten	ZITTEN	TO-SIT.mpeg			
TO-SKI	skiën	SKIËN	TO-SKI.mpeg			
TO-SLAP	slaan	SLAAN	TO-SLAP.mpeg			
TO-SLEEP	slapen	SLAPEN	TO-SLEEP.mpeg			
TO-SMOKE	roken	ROKEN	TO-SMOKE.mpeg			
TO-SMS	sms'en	SMS'EN	TO-SMS.mpeg			
TO-SOAP	inzepen	INZEPEN	TO-SOAP.mpeg			
TO-SPEAK	praten	PRATEN	TO-SPEAK.mpeg			
TO-SPRAY (garden)	besproeien	BESPROEIEN	TO-SPRAY.mpeg	TO-SPRAY_INSPUITEN.mpeg		
TO-STAND	staan	STAAN	TO-STAND.mpeg			
TO-STAPLE	nieten	NIETEN	TO-STAPLE.mpeg			
TO-STEAL	stelen	STELEN	TO-STEAL.mpeg			
TO-STINK	stinken	STINKEN	TO-STINK.mpeg			
TO-SWIM	zwemmen	ZWEMMEN	TO-SWIM.mpeg			
TO-TAKE-PHOTO	fotograferen	FOTOGRAFEREN	TO-TAKE-PHOTO.mpeg			
TO-TAKE-SHOWER	douchen	DOUCHEN	TO-TAKE-SHOWER.mpeg			
TO-TEAR	scheuren	SCHEUREN	TO-TEAR.mpeg			
TO-TICKLE	kietelen	KIETELEN	TO-TICKLE.mpeg			
TO-TOAST	proosten	PROOSTEN	TO-TOAST.mpeg			
TO-TURN-OFF	uitdoen	UITDOEN	TO-TURN-OFF.mpeg			
TO-UNCORK	ontkurken	ONTKURKEN	TO-UNCORK.mpeg			
TO-UNDRESS	uitkleden	UITKLEDEN	TO-UNDRESS.mpeg			
TO-VOMIT	overgeven	OVERGEVEN	TO-VOMIT.mpeg			
TO-WALK	lopen	LOPEN	TO-WALK.mpeg	TO-WALK2.mpeg		
TO-WASH	wassen	WASSEN	TO-WASH.mpeg			
TO-WATCH	kijken	KIJKEN	TO-WATCH.mpeg			
TO-WAVE (someone)	uitzwaaien	UITZWAAIEN	TO-WAVE.mpeg			
TOWEL	handdoek	HANDDOEK	TOWEL.mpeg			
TO-WHISK	opkloppen	OPKLOPPEN	TO-WHISK.mpeg			
TO-WRING	wringen	WRINGEN	TO-WRING.mpeg			
TO-WRITE	schrijven	SCHRIJVEN	TO-WRITE.mpeg			
TRAIN	train	TREIN	TRAIN.mpeg			
TREE	boom	BOOM	TREE.mpeg			
TRUCK	vachtwagen	VRACHTWAGEN	TRUCK.mpeg			
TURTLE	schildpad	SCHILDPAD	TURTLE.mpeg			
UMBRELLA	paraplu	PARAPLU	UMBRELLA.mpeg			
UNICORN	eenhoorn	EENHOORN	UNICORN.mpeg			
VIOLIN	viool	VIOOL	VIOLIN.mpeg			
WALL	muur	MUUR	WALL.mpeg			
WATCH	horloge	HORLOGE	WATCH.mpeg			
WATER	water	WATER	WATER.mpeg			
WHEELCHAIR	rolstoel	ROLSTOEL	WHEELCHAIR.mpeg			
WINDMILL	molen	MOLEN	WINDMILL.mpeg			
WINDOW	raam	RAAM	WINDOW.mpeg			
WINDSCREEN WIPER	ruitenwisser	RUITENWISSER	WINDSCREEN_WIPER.mpeg			
WINE	wijn	WIJN	WINE.mpeg			
WOMAN	vrouw	VROUW	WOMAN.mpeg	WOMAN (2).mpeg		
WRAP	wrap	WRAP	WRAP.mpeg			
ZIMMER FRAME	rollator	ROLLATOR	ZIMMER.mpeg			
						
						
						
			CORK.mpeg			
			SEVEN.mpeg			
			THUMB.mpeg			
						
CRUTCHES	krukken	KRUKKEN	CRUTCHES.mpeg			
						
TO-GESTURE-COME	wenken	WENKEN	TO-GESTURE-COME.mpeg			
